13 13 13 13 13 13 13 13 13 13 13 13 13 13 13 13 13 13 13 13
13 13 13 13 13 13 13 13 13 13 13 13 13 13 13 13 13 13 13 13
1 2 2 2 2 2 2 2 2 2 2 2 2 2 2 2 2 2 2 3
8 0 0 0 0 0 12 0 0 0 0 0 0 12 0 0 0 0 0 4
8 0 0 0 0 0 12 0 0 0 0 0 0 12 0 0 0 0 0 4
8 12 12 12 0 0 12 0 0 0 0 0 0 12 0 0 12 12 12 4
8 0 0 12 0 0 10 12 12 9 9 12 12 10 0 0 12 0 0 4
8 0 0 12 0 0 12 0 0 0 0 0 0 12 0 0 12 0 0 4
8 0 0 12 0 0 10 12 12 9 9 12 12 10 0 0 12 0 0 4
8 12 12 12 0 0 12 0 0 0 0 0 0 12 0 0 12 12 12 4
8 0 0 0 0 0 12 0 0 0 0 0 0 12 0 0 0 0 0 4
8 0 0 0 0 0 12 0 0 0 0 0 0 12 0 0 0 0 0 4
7 6 6 6 6 6 6 6 6 6 6 6 6 6 6 6 6 6 6 5