13 13 13 13 13 13 13 13 13 13 13 13 13 13 13 13 13 13 13 13
1  2  2  2  2  2  2  2  2  2  2  2  2  2  2  2  2  2  2  3
8  0  0  0  0  0  0  0  0  0  0  0  0  0  0  0  0  0  0  4
8  0  0  0  0  0  0  0  0  0  0  0  0  0  0  0  0  0  0  4
8  0  0  0  0  0  0  0  0  0  0  0  0  0  0  0  0  0  0  4
8  0  0  0  0  0  0  0  0  0  0  0  0  0  0  0  0  0  0  4
8  0  0  0  0  0  0  0  0  0  0  0  0  0  0  0  0  0  0  4
8  0  0  0  0  0  0  0  0  0  0  0  0  0  0  0  0  0  0  4
8  0  0  0  0  0  0  0  0  0  0  0  0  0  0  0  0  0  0  4
8  0  0  0  0  0  0  0  0  0  0  0  0  0  0  0  0  0  0  4
8  0  0  0  0  0  0  0  0  0  0  0  0  0  0  0  0  0  0  4
7  6  6  6  6  6  6  6  6  6  6  6  6  6  6  6  6  6  6  5